******************************
*                            *
*    **** ** ******  *       *
*                            *
*   ******      ******       *
*                        *   *
*         *               *  *
*    ****          ****      *
*          ****              *
*           *          *     *
*     **                     *
*                *           *
*    *     ************      *
*                            *
*      *       ****     L    *
*      *                     *
*      *     ****            *
*     *             *****    *
*           *                *
******************************
