*************************************
*                            ****   *
*    **** ** ******  *              *
*                                   *
*   ******      ******       **     *
*                        *          *
*         *               *         *
*    ****          ****             *
*          ****                     *
*           *          *            *
*     **                            *
*                *             **** *
*    *     ************             *
*                                   *
*      *       ****     L   ****    *
*      *                            *
*      *     ****                   *
*     *             *****           *
*           *                  **   *
*                                   *
*                            **     *
*               *****               *
*                                   *
*************************************
